h h h h h h h h h h h h h h h h h h h h h h h h h h h h h h h h h h h h h h h h h h h h h h h h h h h h h h h h h h h h h h h h
h h h h h h h h h h h h h h h h h h h h h h h h h h h h h h h h h h h h h h h h h h h h h h h h h h h h h h h h h h h h h h h h
h h h h h h h h h h h h h h h h h h h h h h h h h h h h h h h h h h h h h h h h h h h h h h h h h h h h h h h h h h h h h h h h
h h h h h h h h h h h h h h h h h h h h h h h h h h h h h h h h h h h h h h h h h h h h h h h h h h h h h h h h h h h h h h h h
h h h h h h h h h h h h h h h h h h h h h h h h h h h h h h h h h h h h h h h h h h h h h h h h h h h h h h h h h h h h h h h h
h h h h h h h h h # # # # # # # # # # # # # # # # # # # # # # # # # # # # # # # # # # # # # # # # # # # # # # # h h h h h h h h
h h h h h h h h h # h h h h h h h h h h h h h h h h h h h h h h h h h h h h h h h h h h h h h h h h h h h F h # h h h h h h h h
h h h h h h h h h # h p h F h h h h F h h h h F h h h h h h h h h h h h h h T h h h h h h h h h h h h h h h h # h h h h h h h h
h h h h h h h h h # h h h h h h h h h h h h h h h h h h h h h h T h h h h h h h h h h h h h h F h h h h h h h # h h h h h h h h
h h h h h h h h h # h h h h F h h h F h h h h h T h h EMV F h h h h h h h h h F h h h T h h h h h h h T h h h h # h h h h h h h h
h h h h h h h h h # h h h h h h h h h h h E h h h h h h h h h h h F h h h h h h E h h h h h h h F h h h h h h # h h h h h h h h
h h h h h h h h h # h h h h h h h h F F h h h h h h h h h h F h h h h h h h h h h h h h h h F h h h h h h h h # h h h h h h h h
h h h h h h h h h # h F h h T h h h h h h h T h h h h # h h h h h h h h h h T h h h F h h h h h h h h h F h h # h h h h h h h h
h h h h h h h h h # h h h h h h F h h F h h h F h h h h h h h T h h F h h h h h h h h h h T h h h E h h h h h # h h h h h h h h
h h h h h h h h h # h h F h h F h h h T h h h h h h h h h h h h h h h h h h h F h T h h h h h h h h h h h h h # h h h h h h h h
h h h h h h h h h # h h h h h h h h h h h h h h h h h h h h h h F h h h h h h h h h h h h h h h h h h T h h h # h h h h h h h h
h h h h h h h h h # h h h h h h h h E h h h h h h h h T h h h h h h h h T h h h h F h h h T h h h h h h h F h # h h h h h h h h
h h h h h h h h h # h F h h h h F h h h h h F h h h h h h h h h EMH h h h h h F h h h h h h h E h F h h h h h h # h h h h h h h h
h h h h h h h h h # h h h h T h h h T h h h h h h h h h h h h h T h h h h h h h T h h F h h h h h h h h h h h # h h h h h h h h
h h h h h h h h h # h F h h h h h h h h h h h h F h h h h F h h h h h h h h h h h h h h h h h h h h h T h h h # h h h h h h h h
h h h h h h h h h # h h h h h h F F h h h h h h h h h h h h h h h h h h h T h h h h h h h h h F h h h h h h h # h h h h h h h h
h h h h h h h h h # h h T h h h h h ES h h h T h h h h h h T h h h h h h h h h F h h h F h h h h h h F h h h h # h h h h h h h h
h h h h h h h h h # h h h h h h h h h h h h h h h h h h h h h h h h h h h h h h h h h h h h h h h h h h h T h # h h h h h h h h
h h h h h h h h h # # # # # # # # # # # # # # # # # # # # # # # # # # # # # # # # # # # # # # # # # # # # # # # h h h h h h h h
h h h h h h h h h h h h h h h h h h h h h h h h h h h h h h h h h h h h h h h h h h h h h h h h h h h h h h h h h h h h h h h h
h h h h h h h h h h h h h h h h h h h h h h h h h h h h h h h h h h h h h h h h h h h h h h h h h h h h h h h h h h h h h h h h
h h h h h h h h h h h h h h h h h h h h h h h h h h h h h h h h h h h h h h h h h h h h h h h h h h h h h h h h h h h h h h h h
h h h h h h h h h h h h h h h h h h h h h h h h h h h h h h h h h h h h h h h h h h h h h h h h h h h h h h h h h h h h h h h h
h h h h h h h h h h h h h h h h h h h h h h h h h h h h h h h h h h h h h h h h h h h h h h h h h h h h h h h h h h h h h h h h
